0,0,0,0,0,0,0,0,0,0,0,0,4,7,3,0,0,0,0,0,0,0,0,0,0,0,0,0,0,0,0,0,0,3,0,0,0,0,0,0,0,0,0,0,0,0,0,0,0,0,0,0,0,0,0,0,0,0,0,4,7,3,0,0,0,0,0,0,0,0,0,3,0,0,0,0,0,0,0,0,0,0,0,0
0,0,0,0,1,0,8,0,0,0,0,0,0,0,2,0,0,0,0,0,0,0,0,2,0,3,7,5,0,0,0,0,0,1,0,0,0,0,0,0,1,0,0,0,3,7,5,0,1,0,0,0,0,0,0,2,0,0,0,0,0,0,0,0,0,3,7,5,0,0,0,0,0,2,0,0,0,3,0,0,0,0,0,0
0,0,0,0,0,0,0,0,0,0,0,0,0,0,0,0,0,0,0,0,0,0,0,3,0,0,0,0,0,2,0,3,7,5,0,2,0,0,3,0,1,0,0,0,0,0,3,7,4,0,0,0,2,0,0,0,0,0,0,0,0,0,0,0,0,4,7,3,0,0,0,0,0,0,0,0,0,0,0,3,0,0,0,0
0,0,0,0,5,0,0,0,0,0,0,0,0,0,0,9,3,0,0,0,0,0,3,0,0,2,0,0,3,0,0,0,0,0,0,0,0,0,0,0,0,0,0,0,0,0,1,0,0,0,0,0,3,0,0,0,0,0,1,4,7,3,0,0,0,0,0,2,0,0,0,3,0,0,0,0,0,0,0,4,7,3,0,3
0,0,0,0,0,0,0,0,0,0,0,0,0,0,0,0,0,4,7,3,0,0,3,7,5,0,0,0,0,1,0,2,0,0,0,3,0,0,0,0,0,0,0,0,0,0,0,0,2,0,0,0,0,0,3,0,0,0,0,0,0,0,0,0,0,0,0,1,0,3,0,1,0,0,0,1,0,0,0,0,0,0,0,0
