0,0,0,0,0,4,0,0,0,0,0,0,0,0,0,0,0,3,0,0,0,0,0,0,0,0,0,0,0,0,0,4,0,0,0,0,3,0,0,0,0,0,0,0
0,0,1,0,0,0,0,2,0,0,0,0,2,0,5,0,0,1,0,0,0,1,0,0,5,1,0,0,2,0,0,0,0,0,0,5,1,0,2,0,0,3,0,0
0,5,0,0,3,0,1,0,4,0,0,0,3,0,0,0,0,5,2,0,3,1,0,0,0,5,0,2,0,0,0,0,0,0,4,0,0,0,0,0,0,0,3,0
0,2,0,0,4,0,4,0,0,0,0,0,0,2,0,3,0,0,0,0,0,0,0,0,1,0,0,3,0,0,1,4,0,0,0,2,0,3,0,0,0,0,0,0
0,0,0,0,1,6,0,3,1,4,0,0,5,0,1,0,2,0,3,7,7,7,7,7,7,2,0,0,3,0,0,0,0,0,0,1,3,1,0,1,0,0,0,0