0,0,0,0,0,0,4,7,3,0,0,0,0,0,0,0,0,3,0,0,0,0,0,0,0,0,0,0,0,0,4,7,3,0,0,0,0,3,0,0,0,0,0,0
0,0,1,0,0,0,0,2,0,0,0,8,2,3,7,5,0,0,1,0,0,1,3,7,5,1,0,0,2,0,0,0,0,3,7,5,0,1,2,0,3,0,0,0
3,7,5,2,0,3,0,1,4,7,3,0,3,0,0,2,3,7,5,2,3,1,0,3,7,5,0,2,0,0,0,0,0,0,4,7,3,0,0,0,0,3,0,0
0,2,0,0,4,7,3,0,0,0,0,0,0,2,0,3,0,0,0,0,0,0,0,0,1,0,0,3,0,1,4,7,3,0,0,2,0,3,0,0,0,5,7,3
0,0,0,0,1,0,0,3,4,7,3,3,7,5,0,1,2,0,3,0,0,0,0,0,0,2,0,0,3,0,0,0,0,0,0,1,3,1,0,1,0,0,0,0
